-1-
9x6
..####...
###..####
#.....o.#
#.#..#o.#
#.*.*#s.#
#########
-2-
6x6
.#####
.#...#
##.o.#
#so*##
#...*#
######